10,11,11,11,11,11,11,11,12,-1,-1,-1,-1,-1,-1,-1,-1,-1,-1,-1,-1,-1,-1,-1,-1,-1,-1,-1,-1,-1,-1,-1,-1,-1,-1,-1,-1,-1,-1,-1,-1,-1,-1,-1,-1,-1,-1,-1,-1,-1,-1,-1,-1,-1,-1,-1,-1,-1,-1,-1,-1,-1,-1,-1,-1,-1,-1,-1,-1,-1,-1,-1,-1,-1,-1,-1,-1,-1,-1,-1,-1,-1,-1,-1,-1,-1,-1,-1,-1,-1,-1,-1,-1,-1,-1,-1,-1,-1,-1,-1,-1,-1,-1,-1,-1,0,1,3,-1,-1,-1,-1,-1,-1,-1,-1,-1,-1,-1,-1,-1,-1,-1,-1,-1,-1,-1,-1,-1,-1,-1,-1,-1,-1,-1,-1,-1,-1,-1,-1,-1,-1,-1,-1,-1,-1,-1,-1,-1,-1,-1,-1,-1,-1
15,16,16,16,16,16,16,16,17,-1,-1,-1,-1,-1,-1,-1,-1,-1,-1,-1,-1,-1,-1,-1,-1,-1,-1,-1,-1,-1,-1,-1,-1,-1,-1,-1,-1,-1,-1,-1,-1,-1,-1,-1,-1,-1,-1,-1,-1,-1,-1,-1,-1,-1,-1,-1,-1,-1,-1,-1,-1,-1,-1,-1,-1,-1,-1,-1,-1,-1,-1,-1,-1,-1,-1,-1,-1,-1,-1,-1,-1,-1,-1,0,1,3,-1,-1,-1,-1,-1,-1,-1,-1,-1,-1,-1,-1,-1,-1,-1,-1,-1,-1,-1,-1,-1,-1,-1,-1,-1,-1,-1,-1,-1,-1,-1,-1,-1,-1,-1,-1,-1,-1,-1,-1,-1,-1,-1,-1,-1,-1,-1,-1,-1,-1,-1,-1,-1,-1,-1,-1,-1,-1,-1,-1,-1,-1,-1,-1,-1,-1,-1,-1
15,16,16,16,16,16,16,16,17,-1,-1,-1,-1,-1,-1,-1,-1,-1,-1,-1,-1,-1,-1,-1,-1,-1,-1,-1,-1,-1,-1,-1,-1,-1,-1,-1,-1,-1,-1,-1,-1,-1,-1,-1,-1,-1,-1,-1,-1,-1,-1,-1,-1,-1,-1,-1,-1,-1,-1,-1,-1,-1,-1,-1,-1,-1,-1,-1,-1,-1,-1,-1,-1,-1,-1,-1,-1,-1,-1,-1,-1,-1,-1,-1,-1,-1,-1,-1,-1,10,12,-1,-1,-1,-1,-1,-1,-1,-1,-1,-1,-1,10,12,-1,-1,-1,-1,10,11,11,12,-1,-1,-1,-1,-1,-1,-1,-1,-1,-1,-1,-1,-1,-1,-1,-1,-1,-1,-1,-1,-1,-1,-1,-1,-1,-1,-1,-1,-1,-1,-1,-1,-1,-1,-1,-1,-1,-1,-1,-1,-1,-1
15,16,16,16,16,16,16,16,17,-1,-1,-1,-1,-1,-1,-1,-1,-1,-1,-1,-1,-1,-1,-1,-1,-1,-1,-1,-1,-1,-1,-1,-1,-1,-1,-1,-1,-1,-1,-1,-1,-1,-1,-1,-1,-1,-1,-1,-1,-1,-1,-1,-1,-1,-1,-1,-1,-1,-1,-1,-1,-1,-1,-1,0,1,1,3,-1,-1,-1,10,11,11,11,12,-1,-1,10,11,11,12,-1,-1,-1,-1,-1,-1,-1,15,17,-1,-1,-1,-1,-1,-1,-1,-1,-1,-1,-1,15,17,-1,-1,-1,-1,20,21,21,22,-1,-1,-1,-1,-1,-1,-1,-1,-1,-1,-1,-1,-1,-1,-1,-1,-1,-1,-1,-1,-1,-1,-1,-1,-1,-1,-1,-1,-1,-1,-1,-1,-1,-1,-1,-1,-1,-1,-1,-1,-1,-1
15,16,16,16,16,16,16,16,17,-1,-1,-1,-1,-1,-1,-1,-1,-1,-1,-1,-1,-1,-1,-1,-1,-1,-1,-1,-1,-1,-1,-1,-1,-1,-1,-1,-1,-1,-1,-1,-1,-1,-1,-1,-1,-1,-1,-1,-1,-1,-1,-1,-1,-1,-1,-1,-1,-1,-1,-1,0,3,-1,-1,-1,-1,-1,-1,-1,-1,-1,20,21,21,21,22,-1,-1,20,21,21,22,-1,-1,-1,-1,0,3,-1,15,17,11,11,11,11,11,11,11,11,11,11,11,15,17,-1,-1,-1,-1,-1,-1,-1,-1,-1,-1,-1,-1,-1,-1,-1,-1,-1,-1,-1,-1,-1,-1,-1,-1,-1,-1,-1,-1,-1,-1,-1,-1,-1,-1,-1,-1,-1,-1,-1,-1,-1,-1,-1,-1,-1,-1,-1,-1,-1,-1
15,16,16,16,16,16,16,16,17,-1,-1,-1,-1,-1,-1,-1,-1,-1,-1,-1,-1,-1,-1,-1,-1,-1,-1,-1,-1,-1,-1,-1,-1,-1,-1,-1,-1,-1,-1,-1,-1,-1,-1,-1,-1,-1,-1,-1,-1,-1,-1,-1,-1,-1,-1,-1,-1,-1,-1,-1,-1,-1,-1,-1,-1,-1,-1,-1,-1,-1,-1,-1,10,11,11,12,-1,-1,-1,-1,-1,-1,-1,10,12,-1,-1,-1,-1,20,22,21,21,21,21,21,21,21,21,21,21,21,20,22,-1,-1,-1,-1,-1,-1,-1,-1,-1,-1,10,12,-1,-1,-1,-1,-1,-1,-1,-1,-1,-1,-1,-1,-1,-1,-1,-1,-1,-1,10,11,11,11,12,-1,-1,-1,-1,-1,-1,-1,-1,-1,-1,-1,-1,-1,-1,-1
15,16,16,16,16,16,16,16,17,-1,-1,-1,-1,-1,-1,-1,-1,-1,-1,-1,-1,-1,-1,-1,-1,-1,-1,-1,-1,-1,-1,-1,-1,-1,-1,-1,-1,-1,-1,-1,-1,-1,-1,-1,-1,-1,-1,-1,-1,-1,-1,-1,-1,-1,-1,-1,-1,-1,-1,-1,-1,-1,-1,0,3,-1,-1,-1,-1,-1,-1,-1,15,21,21,22,-1,-1,-1,-1,-1,-1,-1,15,17,-1,-1,-1,-1,-1,-1,-1,-1,-1,-1,-1,-1,-1,-1,-1,-1,-1,-1,-1,-1,-1,-1,-1,-1,-1,-1,-1,-1,-1,15,17,-1,-1,10,-1,-1,-1,-1,-1,-1,-1,-1,-1,-1,-1,-1,-1,-1,-1,15,16,16,16,17,-1,-1,-1,-1,-1,-1,-1,-1,-1,-1,-1,-1,-1,-1,-1
15,16,16,16,16,16,16,16,17,-1,-1,-1,-1,-1,-1,-1,-1,-1,-1,-1,-1,-1,-1,-1,-1,-1,-1,-1,-1,-1,-1,-1,-1,-1,-1,-1,-1,-1,-1,-1,-1,-1,-1,-1,-1,-1,-1,-1,-1,-1,-1,-1,-1,-1,-1,-1,-1,-1,-1,-1,-1,-1,-1,-1,-1,-1,-1,-1,-1,-1,-1,-1,15,-1,-1,-1,-1,-1,-1,-1,-1,10,12,15,17,-1,-1,-1,-1,-1,-1,-1,-1,-1,-1,-1,-1,-1,-1,-1,-1,-1,-1,-1,-1,-1,-1,-1,-1,-1,-1,-1,-1,-1,15,17,-1,-1,15,12,-1,-1,-1,-1,-1,-1,-1,-1,-1,-1,-1,0,2,3,15,16,16,16,17,11,12,-1,-1,-1,-1,-1,-1,-1,-1,-1,-1,-1,-1,-1
15,16,16,16,16,16,16,16,17,-1,-1,-1,-1,-1,-1,-1,-1,-1,-1,-1,-1,-1,-1,-1,-1,-1,-1,-1,-1,-1,-1,-1,-1,-1,-1,-1,-1,-1,-1,-1,-1,-1,-1,-1,-1,-1,-1,-1,-1,-1,-1,-1,0,1,3,-1,-1,-1,-1,-1,-1,10,12,-1,-1,-1,-1,-1,-1,-1,-1,-1,15,-1,-1,-1,-1,-1,-1,-1,-1,15,17,20,22,-1,-1,-1,-1,-1,-1,-1,-1,-1,-1,-1,-1,-1,-1,-1,-1,-1,-1,-1,-1,-1,-1,-1,-1,-1,-1,-1,-1,-1,15,17,-1,-1,15,17,-1,-1,-1,-1,-1,-1,-1,-1,-1,-1,-1,-1,-1,-1,20,21,21,21,22,21,22,-1,0,-1,-1,-1,-1,-1,-1,-1,-1,-1,-1,-1
15,16,16,16,16,16,16,16,17,-1,-1,-1,-1,-1,-1,-1,-1,-1,-1,-1,-1,-1,-1,-1,-1,-1,10,11,12,-1,-1,-1,-1,-1,-1,-1,-1,-1,-1,-1,-1,-1,-1,-1,-1,-1,-1,-1,-1,-1,-1,-1,-1,-1,-1,-1,-1,-1,-1,-1,-1,15,17,-1,-1,-1,-1,-1,-1,-1,-1,-1,15,11,11,11,11,11,11,11,11,15,17,-1,-1,-1,-1,-1,-1,-1,-1,-1,-1,-1,-1,-1,-1,-1,-1,-1,-1,-1,-1,-1,-1,-1,-1,-1,-1,-1,-1,-1,-1,-1,15,17,-1,-1,15,17,-1,-1,10,12,-1,-1,0,1,1,3,-1,-1,-1,-1,-1,-1,-1,-1,-1,-1,-1,-1,-1,-1,-1,-1,-1,-1,-1,-1,-1,-1,-1,-1
15,16,16,16,16,16,16,16,17,10,11,11,11,11,11,11,11,12,-1,-1,-1,-1,-1,-1,-1,-1,15,16,17,-1,-1,-1,-1,-1,-1,0,1,3,-1,-1,-1,-1,-1,-1,-1,-1,-1,-1,-1,-1,0,3,-1,-1,-1,10,11,11,11,12,-1,15,17,-1,-1,-1,-1,-1,-1,-1,-1,-1,20,21,21,21,21,21,21,21,21,20,22,-1,-1,-1,-1,-1,-1,-1,-1,-1,-1,-1,-1,-1,-1,-1,-1,-1,-1,-1,-1,-1,-1,-1,-1,-1,-1,-1,-1,-1,-1,-1,15,17,-1,-1,15,17,12,-1,20,22,-1,-1,-1,-1,-1,-1,-1,-1,-1,-1,-1,-1,-1,-1,-1,-1,-1,-1,-1,-1,10,12,-1,-1,-1,-1,-1,-1,-1,-1
15,16,16,16,16,16,16,16,17,15,16,16,16,16,16,16,16,17,10,11,11,11,11,11,11,12,15,16,17,-1,-1,-1,-1,-1,-1,-1,-1,-1,10,12,-1,-1,-1,-1,-1,-1,10,11,12,-1,-1,-1,-1,-1,-1,15,16,16,16,17,-1,15,17,-1,-1,-1,-1,-1,-1,-1,-1,-1,-1,-1,-1,-1,-1,-1,-1,-1,-1,-1,-1,-1,-1,-1,-1,-1,-1,-1,-1,-1,-1,-1,-1,-1,-1,-1,-1,-1,-1,-1,-1,-1,-1,-1,-1,-1,-1,-1,-1,-1,-1,-1,15,17,-1,-1,15,17,22,-1,-1,-1,-1,-1,-1,-1,-1,-1,-1,-1,0,-1,-1,-1,-1,-1,-1,-1,-1,-1,-1,-1,15,17,-1,-1,10,11,11,11,11,12
15,16,16,16,16,16,16,16,17,15,16,16,16,16,16,16,16,17,15,16,16,16,16,16,16,17,15,16,17,12,-1,-1,10,11,12,-1,-1,-1,15,17,10,11,11,11,11,12,15,16,17,-1,-1,-1,-1,-1,-1,15,16,16,16,17,-1,15,17,-1,-1,-1,-1,-1,-1,-1,-1,-1,-1,-1,-1,-1,-1,-1,-1,-1,-1,-1,-1,-1,-1,-1,-1,-1,-1,-1,-1,-1,-1,-1,-1,-1,-1,-1,-1,-1,-1,-1,-1,-1,-1,-1,-1,-1,-1,-1,-1,-1,-1,-1,15,17,-1,-1,15,17,-1,-1,-1,-1,-1,10,11,11,11,11,11,12,-1,-1,10,11,11,11,11,11,11,11,12,-1,15,17,-1,-1,15,16,16,16,16,17
15,16,16,16,16,16,16,16,17,15,16,16,16,16,16,16,16,17,15,16,16,16,16,16,16,17,15,16,17,17,11,11,15,16,17,-1,-1,-1,15,17,15,16,16,16,16,17,15,16,17,-1,-1,-1,-1,-1,-1,15,16,16,16,17,-1,15,17,-1,-1,-1,-1,-1,-1,-1,-1,-1,-1,-1,-1,-1,-1,-1,-1,-1,-1,-1,-1,-1,-1,-1,-1,-1,-1,-1,-1,-1,-1,-1,-1,-1,-1,-1,-1,-1,-1,-1,-1,-1,-1,-1,-1,-1,-1,-1,-1,-1,-1,-1,15,17,-1,-1,15,17,-1,0,10,12,-1,15,16,16,16,16,16,17,-1,-1,15,16,16,16,16,16,16,16,17,-1,15,17,-1,-1,15,16,16,16,16,17
15,16,16,16,16,16,16,16,17,15,16,16,16,16,16,16,16,17,15,16,16,16,16,16,16,17,15,16,17,17,16,16,15,16,17,-1,-1,-1,15,17,15,16,16,16,16,17,15,16,17,-1,-1,-1,-1,-1,-1,15,16,16,16,17,-1,15,17,-1,-1,-1,-1,-1,-1,-1,-1,-1,-1,-1,-1,-1,-1,-1,-1,-1,-1,-1,-1,-1,-1,-1,-1,-1,-1,-1,-1,-1,-1,-1,-1,-1,-1,-1,-1,-1,-1,-1,-1,-1,-1,-1,-1,-1,-1,-1,-1,-1,-1,-1,15,17,-1,-1,15,17,-1,-1,15,17,-1,15,16,16,16,16,16,17,-1,-1,15,16,16,16,16,16,16,16,17,-1,15,17,-1,-1,15,16,16,16,16,17
15,16,16,16,16,16,16,16,17,15,16,16,16,16,16,16,16,17,15,16,16,16,16,16,16,17,15,16,17,17,16,16,15,16,17,-1,-1,-1,15,17,15,16,16,16,16,17,15,16,17,-1,-1,-1,-1,-1,-1,15,16,16,16,17,-1,15,17,-1,-1,-1,-1,-1,-1,-1,-1,-1,-1,-1,-1,-1,-1,-1,-1,-1,-1,-1,-1,-1,-1,-1,-1,-1,-1,-1,-1,-1,-1,-1,-1,-1,-1,-1,-1,-1,-1,-1,-1,-1,-1,-1,-1,-1,-1,-1,-1,-1,-1,-1,15,17,-1,-1,15,17,-1,-1,15,17,-1,15,16,16,16,16,16,17,-1,-1,15,16,16,16,16,16,16,16,17,-1,15,17,-1,-1,15,16,16,16,16,17
15,16,16,16,16,16,16,16,17,15,16,16,16,16,16,16,16,17,15,16,16,16,16,16,16,17,15,16,17,17,16,16,15,16,17,-1,-1,-1,15,17,15,16,16,16,16,17,15,16,17,-1,-1,-1,-1,-1,-1,15,16,16,16,17,-1,15,17,-1,-1,-1,-1,-1,-1,-1,-1,-1,-1,-1,-1,-1,-1,-1,-1,-1,-1,-1,-1,-1,-1,-1,-1,-1,-1,-1,-1,-1,-1,-1,-1,-1,-1,-1,-1,-1,-1,-1,-1,-1,-1,-1,-1,-1,-1,-1,-1,-1,-1,-1,15,17,-1,-1,15,17,-1,-1,15,17,-1,15,16,16,16,16,16,17,-1,-1,15,16,16,16,16,16,16,16,17,-1,15,17,-1,-1,15,16,16,16,16,17
15,16,16,16,16,16,16,16,17,15,16,16,16,16,16,16,16,17,15,16,16,16,16,16,16,17,15,16,17,17,16,16,15,16,17,-1,-1,-1,15,17,15,16,16,16,16,17,15,16,17,-1,-1,-1,-1,-1,-1,15,16,16,16,17,-1,15,17,-1,-1,-1,-1,-1,-1,-1,-1,-1,-1,-1,-1,-1,-1,-1,-1,-1,-1,-1,-1,-1,-1,-1,-1,-1,-1,-1,-1,-1,-1,-1,-1,-1,-1,-1,-1,-1,-1,-1,-1,-1,-1,-1,-1,-1,-1,-1,-1,-1,-1,-1,15,17,-1,-1,15,17,-1,-1,15,17,-1,15,16,16,16,16,16,17,-1,-1,15,16,16,16,16,16,16,16,17,-1,15,17,-1,-1,15,16,16,16,16,17
15,16,16,16,16,16,16,16,17,15,16,16,16,16,16,16,16,17,15,16,16,16,16,16,16,17,15,16,17,17,16,16,15,16,17,-1,-1,-1,15,17,15,16,16,16,16,17,15,16,17,-1,-1,-1,-1,-1,-1,15,16,16,16,17,-1,15,17,-1,-1,-1,-1,-1,-1,-1,-1,-1,-1,-1,-1,-1,-1,-1,-1,-1,-1,-1,-1,-1,-1,-1,-1,-1,-1,-1,-1,-1,-1,-1,-1,-1,-1,-1,-1,-1,-1,-1,-1,-1,-1,-1,-1,-1,-1,-1,-1,-1,-1,-1,15,17,-1,-1,15,17,-1,-1,15,17,-1,15,16,16,16,16,16,17,-1,-1,15,16,16,16,16,16,16,16,17,-1,15,17,-1,-1,15,16,16,16,16,17
15,16,16,16,16,16,16,16,17,15,16,16,16,16,16,16,16,17,15,16,16,16,16,16,16,17,15,16,17,17,16,16,15,16,17,-1,-1,-1,15,17,15,16,16,16,16,17,15,16,17,-1,-1,-1,-1,-1,-1,15,16,16,16,17,-1,15,17,-1,-1,-1,-1,-1,-1,-1,-1,-1,-1,-1,-1,-1,-1,-1,-1,-1,-1,-1,-1,-1,-1,-1,-1,-1,-1,-1,-1,-1,-1,-1,-1,-1,-1,-1,-1,-1,-1,-1,-1,-1,-1,-1,-1,-1,-1,-1,-1,-1,-1,-1,15,17,-1,-1,15,17,-1,-1,15,17,-1,15,16,16,16,16,16,17,-1,-1,15,16,16,16,16,16,16,16,17,-1,15,17,-1,-1,15,16,16,16,16,17
