11,11,11,11,11,11,11,11,12,12,-1,-1,-1,-1,-1,-1,-1,-1,-1,-1,-1,-1,-1,-1,-1,-1,-1,-1,-1,-1,-1,-1,-1,-1,-1,-1,-1,-1,-1,-1,-1,-1,-1,-1,-1,-1,-1,-1,-1,-1,-1,-1,-1,-1,-1,-1,-1,-1,-1,-1,-1,-1,-1,-1,-1,-1,-1,-1,-1,-1,10,11,11,11,11,11,11,11,12,10,11,11,11,12,-1,-1,-1,-1,-1,10,11,11,11,11,11,12,-1,-1,-1,-1,-1,-1,-1,-1,-1,-1,-1,-1,-1,-1,-1,-1,-1,-1,-1,-1,-1,-1,-1,-1,-1,-1,-1,-1,-1,-1,-1,-1,-1,-1,-1,-1,-1,-1,-1,-1,-1,-1,-1,-1,-1,-1,-1,-1,-1,-1,-1,-1,-1,-1,-1,-1,-1,-1,-1,-1,-1,-1,-1,-1,-1,-1,-1,-1,-1,-1,-1,-1,-1,-1,-1,-1,-1,-1,-1,-1,-1,-1,-1,-1,-1,-1,-1,-1,-1,-1,-1,-1,-1,-1,-1,-1,-1,-1,-1,-1,-1,-1,-1,-1
16,16,16,16,16,16,16,16,17,17,-1,-1,-1,-1,-1,-1,-1,-1,-1,-1,-1,-1,-1,-1,-1,-1,-1,-1,-1,-1,-1,-1,-1,-1,-1,-1,-1,-1,-1,-1,-1,-1,-1,-1,-1,-1,-1,-1,-1,-1,-1,-1,-1,-1,-1,-1,-1,-1,-1,-1,-1,-1,-1,-1,-1,-1,-1,-1,-1,-1,15,16,-1,16,16,16,16,16,17,15,16,16,16,17,12,-1,-1,-1,10,15,16,16,16,16,21,17,-1,-1,-1,10,5,12,-1,-1,-1,-1,-1,-1,-1,-1,-1,-1,-1,-1,-1,-1,-1,-1,-1,-1,-1,-1,-1,-1,-1,-1,-1,-1,-1,-1,-1,-1,-1,-1,-1,-1,-1,-1,-1,-1,-1,-1,-1,-1,-1,-1,-1,-1,-1,-1,-1,-1,-1,-1,-1,-1,-1,-1,-1,-1,-1,-1,-1,-1,-1,-1,-1,-1,-1,-1,-1,-1,-1,-1,-1,-1,-1,-1,-1,-1,-1,-1,-1,-1,-1,-1,-1,-1,-1,-1,-1,-1,-1,-1,-1,-1,-1,-1,-1,-1
16,16,16,16,16,16,16,16,17,17,-1,-1,-1,-1,-1,-1,-1,-1,-1,-1,-1,-1,-1,-1,-1,-1,-1,-1,-1,-1,-1,-1,-1,-1,-1,-1,-1,-1,-1,-1,-1,-1,-1,-1,0,3,-1,-1,-1,-1,-1,-1,-1,-1,-1,-1,-1,-1,-1,-1,-1,-1,-1,-1,-1,-1,-1,-1,-1,-1,15,16,-1,16,16,16,16,16,17,15,16,16,16,17,17,12,-1,10,15,15,16,16,16,16,-1,17,-1,-1,0,15,16,17,1,-1,-1,-1,-1,-1,-1,-1,-1,-1,-1,-1,-1,-1,-1,-1,-1,-1,-1,-1,-1,-1,-1,-1,-1,-1,-1,-1,-1,-1,-1,-1,-1,-1,-1,-1,-1,-1,-1,-1,-1,-1,-1,-1,-1,-1,-1,-1,-1,-1,-1,-1,-1,-1,-1,-1,-1,-1,-1,-1,-1,-1,-1,-1,-1,-1,-1,-1,-1,-1,-1,-1,-1,-1,-1,-1,-1,-1,-1,-1,-1,-1,-1,-1,-1,-1,-1,-1,-1,-1,-1,-1,-1,-1,-1,-1,-1,-1
16,16,16,16,16,16,16,16,17,17,-1,-1,-1,-1,-1,-1,-1,-1,-1,-1,-1,-1,-1,-1,-1,-1,-1,-1,-1,-1,-1,-1,-1,-1,-1,-1,-1,-1,-1,-1,-1,-1,-1,-1,-1,-1,-1,-1,-1,-1,-1,-1,-1,-1,-1,-1,-1,-1,-1,-1,-1,-1,-1,-1,10,6,8,12,-1,-1,15,16,-1,16,16,16,16,16,17,15,16,16,16,17,17,17,11,15,15,15,16,16,16,16,-1,17,-1,-1,-1,15,16,17,-1,-1,-1,1,1,1,-1,-1,-1,-1,-1,-1,-1,-1,-1,-1,-1,-1,-1,-1,-1,-1,-1,-1,-1,-1,-1,-1,-1,-1,-1,-1,-1,-1,-1,-1,-1,-1,-1,-1,-1,-1,-1,-1,-1,-1,-1,-1,-1,-1,-1,-1,-1,-1,-1,-1,-1,-1,-1,-1,-1,-1,-1,-1,-1,-1,-1,-1,-1,-1,-1,-1,-1,-1,-1,-1,-1,-1,-1,-1,-1,-1,-1,-1,-1,-1,0,1,1,1,1,3,-1,-1,-1,-1,-1,-1
16,16,16,16,16,16,16,16,17,17,-1,-1,-1,-1,-1,-1,-1,-1,-1,-1,-1,-1,-1,-1,-1,-1,0,1,1,3,-1,-1,-1,-1,-1,-1,-1,-1,-1,-1,0,3,-1,-1,-1,-1,-1,-1,-1,-1,-1,-1,-1,-1,-1,-1,-1,-1,-1,-1,-1,-1,-1,-1,15,16,16,17,-1,-1,15,16,11,16,16,16,16,16,17,15,16,16,16,17,17,17,16,15,15,15,16,16,16,16,-1,17,3,-1,-1,15,16,17,-1,-1,-1,-1,-1,-1,-1,-1,-1,-1,-1,-1,-1,-1,-1,-1,-1,-1,-1,-1,-1,-1,-1,-1,-1,-1,-1,-1,-1,-1,-1,-1,-1,-1,-1,-1,-1,-1,-1,-1,-1,-1,-1,-1,-1,-1,-1,-1,-1,-1,-1,-1,-1,-1,-1,-1,-1,-1,-1,-1,-1,-1,-1,-1,-1,-1,-1,-1,-1,-1,-1,-1,-1,-1,-1,-1,-1,-1,-1,-1,-1,-1,-1,-1,-1,-1,-1,-1,-1,-1,-1,-1,-1,-1,-1,-1,-1,-1
16,16,16,16,16,16,16,16,17,17,-1,-1,-1,-1,-1,-1,-1,-1,-1,-1,-1,-1,-1,-1,-1,-1,-1,-1,-1,-1,-1,-1,-1,-1,-1,-1,-1,-1,-1,-1,-1,-1,-1,-1,0,3,-1,-1,-1,-1,-1,-1,-1,-1,-1,-1,-1,-1,10,12,-1,-1,-1,-1,15,21,21,17,-1,-1,15,21,21,21,21,21,21,21,22,15,16,16,16,17,17,17,16,15,15,15,16,16,16,16,-1,17,-1,-1,-1,15,16,17,-1,-1,-1,-1,-1,-1,-1,-1,-1,-1,-1,-1,-1,-1,-1,-1,-1,-1,-1,-1,-1,-1,-1,-1,-1,-1,-1,-1,-1,-1,-1,-1,-1,-1,-1,-1,-1,-1,-1,-1,-1,-1,-1,-1,-1,-1,-1,-1,-1,-1,-1,-1,-1,-1,-1,-1,-1,-1,-1,-1,-1,-1,-1,-1,-1,-1,-1,-1,-1,-1,-1,-1,-1,-1,-1,-1,-1,-1,-1,-1,-1,-1,-1,-1,-1,-1,-1,-1,-1,-1,-1,0,3,-1,-1,0,3,-1
16,16,16,16,16,16,16,16,17,22,-1,-1,-1,-1,-1,-1,-1,-1,-1,-1,-1,-1,0,1,3,-1,-1,-1,-1,-1,-1,0,3,-1,0,3,-1,-1,-1,-1,-1,-1,-1,-1,-1,-1,-1,-1,-1,-1,-1,-1,-1,-1,-1,-1,-1,-1,15,17,-1,10,12,-1,15,-1,-1,17,-1,-1,15,-1,-1,-1,-1,-1,-1,1,1,15,16,16,16,17,17,17,16,15,15,15,16,16,16,16,11,17,-1,-1,0,15,16,17,-1,10,9,12,-1,-1,-1,-1,-1,-1,-1,-1,-1,-1,-1,-1,-1,-1,-1,-1,-1,-1,-1,-1,-1,-1,-1,-1,-1,-1,-1,-1,-1,-1,-1,10,12,-1,-1,-1,-1,0,3,-1,-1,-1,-1,-1,-1,-1,-1,-1,-1,-1,-1,-1,-1,-1,-1,-1,-1,-1,-1,-1,-1,-1,-1,-1,-1,-1,-1,-1,-1,-1,-1,-1,-1,-1,-1,-1,-1,-1,-1,-1,-1,-1,-1,-1,-1,-1,-1,-1,-1,-1,-1,-1,-1,-1
16,16,16,16,16,16,16,16,17,-1,-1,-1,-1,-1,-1,-1,-1,-1,-1,-1,-1,-1,-1,-1,-1,-1,-1,-1,-1,-1,-1,-1,-1,-1,-1,-1,-1,-1,-1,-1,0,1,3,-1,-1,-1,-1,-1,-1,-1,-1,-1,-1,-1,10,12,-1,-1,15,17,-1,15,17,-1,15,-1,-1,17,-1,-1,15,-1,-1,10,12,-1,-1,-1,0,20,21,21,21,22,22,17,16,15,20,20,21,21,21,16,16,17,-1,-1,-1,15,16,17,-1,15,16,17,-1,0,2,-1,-1,-1,1,1,1,-1,-1,1,1,-1,10,9,12,-1,-1,-1,-1,-1,-1,-1,-1,-1,-1,-1,-1,-1,-1,15,17,-1,-1,-1,-1,-1,-1,-1,0,1,3,-1,-1,-1,-1,-1,-1,-1,-1,-1,-1,-1,-1,-1,-1,-1,-1,-1,-1,-1,-1,-1,-1,-1,-1,-1,-1,-1,-1,-1,-1,-1,-1,-1,-1,-1,-1,-1,-1,-1,-1,-1,-1,-1,-1,-1,-1,0,3,-1,-1,-1
16,16,16,16,16,16,16,16,17,-1,-1,-1,-1,-1,-1,-1,-1,-1,-1,-1,-1,-1,-1,-1,-1,-1,-1,-1,-1,-1,-1,-1,-1,-1,-1,-1,-1,-1,-1,-1,-1,-1,-1,-1,-1,-1,-1,-1,-1,-1,-1,-1,-1,-1,15,17,-1,-1,15,17,-1,15,17,-1,15,-1,-1,17,-1,-1,15,-1,-1,15,17,-1,-1,-1,-1,-1,-1,-1,-1,1,20,22,16,20,22,1,1,1,1,20,21,22,2,-1,-1,15,16,17,-1,15,16,17,-1,-1,-1,-1,-1,-1,-1,-1,-1,-1,-1,-1,-1,-1,15,16,17,-1,-1,-1,-1,-1,-1,-1,-1,-1,-1,-1,-1,-1,-1,15,17,-1,-1,-1,-1,-1,-1,-1,-1,-1,-1,-1,-1,-1,-1,-1,-1,-1,-1,-1,-1,-1,-1,-1,-1,-1,-1,-1,-1,-1,-1,-1,-1,-1,-1,-1,-1,-1,-1,-1,-1,-1,-1,-1,-1,-1,-1,-1,-1,-1,-1,-1,-1,-1,-1,-1,-1,-1,-1,-1,-1,-1
16,16,16,16,16,16,16,16,17,-1,-1,-1,-1,-1,-1,-1,-1,-1,-1,-1,-1,-1,-1,-1,-1,-1,-1,-1,-1,-1,-1,-1,-1,-1,-1,-1,-1,-1,-1,-1,-1,-1,-1,-1,-1,-1,-1,-1,-1,-1,10,12,-1,-1,15,17,-1,-1,15,17,-1,15,17,-1,15,11,11,17,-1,-1,15,11,12,15,17,1,0,-1,-1,-1,-1,-1,-1,-1,-1,20,21,22,-1,0,0,0,-1,-1,-1,-1,-1,-1,-1,15,16,17,-1,15,16,17,-1,-1,-1,-1,-1,-1,-1,-1,-1,-1,-1,-1,-1,-1,15,16,17,10,9,12,-1,-1,-1,-1,-1,-1,-1,-1,-1,10,5,12,17,0,1,3,-1,-1,-1,-1,-1,-1,-1,-1,-1,-1,-1,-1,-1,-1,-1,-1,-1,-1,-1,-1,-1,-1,-1,-1,-1,-1,-1,-1,-1,-1,-1,-1,-1,-1,-1,-1,-1,-1,-1,-1,-1,-1,-1,-1,-1,-1,-1,-1,-1,-1,-1,0,1,3,-1,-1,-1,-1
16,16,16,16,16,16,16,16,17,12,-1,-1,-1,-1,-1,-1,-1,-1,-1,-1,-1,-1,-1,-1,0,1,1,3,-1,-1,-1,-1,-1,-1,-1,-1,-1,10,12,-1,-1,-1,-1,-1,-1,-1,-1,-1,-1,10,16,17,-1,-1,15,17,-1,-1,15,17,-1,15,17,-1,15,16,16,17,-1,-1,20,21,22,20,22,-1,-1,-1,-1,-1,-1,-1,-1,-1,-1,-1,-1,-1,-1,-1,-1,-1,-1,-1,-1,-1,-1,-1,0,15,16,17,-1,15,16,17,-1,-1,-1,0,1,3,-1,-1,-1,-1,-1,-1,-1,-1,15,16,17,15,16,17,10,6,6,5,6,7,8,9,12,15,16,17,17,-1,-1,-1,-1,-1,-1,-1,-1,-1,-1,-1,0,3,-1,1,3,-1,-1,-1,-1,-1,-1,-1,-1,-1,-1,-1,-1,-1,-1,-1,-1,-1,-1,-1,-1,-1,-1,-1,-1,-1,-1,-1,-1,-1,-1,-1,-1,-1,-1,-1,-1,-1,-1,-1,-1,-1,-1,-1,-1,-1
16,16,16,16,16,16,16,16,17,17,-1,10,11,5,6,7,8,9,12,-1,-1,-1,-1,-1,-1,-1,-1,-1,-1,-1,-1,-1,-1,-1,-1,-1,-1,15,17,10,6,8,11,5,6,7,8,9,12,15,16,17,-1,-1,15,17,-1,-1,15,17,-1,15,17,-1,15,16,16,17,-1,-1,-1,-1,-1,-1,-1,-1,-1,-1,-1,-1,-1,-1,-1,-1,-1,-1,-1,-1,-1,-1,-1,-1,-1,-1,-1,-1,-1,-1,-1,15,16,17,-1,15,16,17,-1,-1,-1,-1,-1,-1,-1,-1,-1,-1,-1,-1,-1,-1,15,16,17,15,16,17,15,16,16,16,16,16,16,16,17,15,16,17,17,-1,-1,-1,-1,-1,-1,-1,-1,-1,-1,-1,-1,-1,-1,-1,-1,10,12,-1,-1,-1,-1,-1,-1,-1,-1,-1,-1,-1,-1,-1,-1,-1,-1,-1,-1,-1,-1,-1,-1,-1,-1,-1,-1,-1,-1,0,1,3,-1,-1,-1,-1,-1,-1,-1,-1,-1,-1,-1,-1
16,16,16,16,16,16,16,16,17,17,-1,15,16,16,16,16,16,16,17,-1,0,2,3,-1,-1,-1,-1,-1,-1,-1,-1,-1,-1,-1,-1,-1,-1,15,17,15,16,16,16,16,16,16,16,16,17,15,16,17,-1,-1,15,17,-1,-1,15,17,-1,15,17,-1,15,16,16,17,-1,-1,-1,-1,-1,-1,-1,10,11,5,6,7,8,11,12,-1,-1,-1,-1,-1,-1,-1,-1,-1,-1,-1,-1,-1,-1,-1,-1,15,16,17,-1,15,16,17,-1,-1,-1,-1,-1,-1,-1,-1,-1,-1,-1,-1,-1,-1,15,16,17,15,16,17,15,16,16,16,16,16,16,16,17,15,16,17,22,-1,-1,-1,-1,-1,-1,-1,-1,-1,-1,-1,-1,-1,-1,-1,-1,15,17,10,12,-1,-1,-1,-1,-1,-1,-1,-1,-1,-1,-1,-1,-1,-1,-1,-1,-1,-1,-1,-1,-1,-1,-1,-1,-1,-1,-1,-1,-1,-1,-1,10,5,5,11,6,7,8,9,12,-1
16,16,16,16,16,16,16,16,17,17,-1,15,16,16,16,16,16,16,17,-1,-1,-1,-1,-1,-1,-1,-1,-1,-1,-1,-1,-1,-1,-1,-1,-1,-1,15,17,15,16,16,16,16,16,16,16,16,17,15,16,17,-1,-1,15,17,-1,-1,15,17,-1,15,17,-1,15,16,16,17,11,11,5,6,7,8,12,15,16,16,16,16,16,16,17,10,11,5,6,7,8,9,12,-1,-1,10,5,6,7,8,12,15,16,17,-1,15,16,17,-1,-1,-1,-1,-1,-1,-1,-1,-1,-1,-1,-1,-1,-1,15,16,17,15,16,17,15,16,16,16,16,16,16,16,17,15,16,17,-1,-1,-1,-1,-1,-1,-1,-1,-1,-1,-1,-1,-1,-1,-1,-1,-1,15,17,15,17,-1,-1,0,2,-1,-1,0,3,-1,-1,0,3,-1,-1,0,3,-1,-1,0,0,-1,-1,10,5,12,-1,-1,-1,-1,-1,-1,15,16,16,16,16,16,16,16,17,-1
16,16,16,16,16,16,16,16,17,17,-1,15,16,16,16,16,16,16,17,-1,-1,-1,-1,-1,-1,-1,-1,-1,-1,-1,-1,-1,-1,-1,-1,-1,-1,15,17,15,16,16,16,16,16,16,16,16,17,15,16,17,-1,-1,15,17,-1,-1,15,17,-1,15,17,-1,15,16,16,17,16,16,16,16,16,16,17,15,16,16,16,16,16,16,17,15,16,16,16,16,16,16,17,-1,-1,15,16,16,16,16,17,15,16,17,-1,15,16,17,-1,-1,-1,-1,-1,-1,-1,-1,-1,-1,-1,-1,-1,-1,15,16,17,15,16,17,15,16,16,16,16,16,16,16,17,15,16,17,-1,-1,-1,-1,-1,-1,-1,-1,-1,-1,-1,-1,-1,-1,-1,-1,-1,15,17,15,17,-1,-1,-1,-1,-1,-1,-1,-1,-1,-1,-1,-1,-1,-1,-1,-1,-1,-1,-1,-1,-1,-1,15,16,17,-1,-1,-1,-1,-1,-1,15,16,16,16,16,16,16,16,17,-1
16,16,16,16,16,16,16,16,17,17,-1,15,16,16,16,16,16,16,17,-1,-1,-1,-1,-1,-1,-1,-1,-1,-1,-1,-1,-1,-1,-1,-1,-1,-1,15,17,15,16,16,16,16,16,16,16,16,17,15,16,17,-1,-1,15,17,-1,-1,15,17,-1,15,17,-1,15,16,16,17,16,16,16,16,16,16,17,15,16,16,16,16,16,16,17,15,16,16,16,16,16,16,17,-1,-1,15,16,16,16,16,17,15,16,17,-1,15,16,17,-1,-1,-1,-1,-1,-1,-1,-1,-1,-1,-1,-1,-1,-1,15,16,17,15,16,17,15,16,16,16,16,16,16,16,17,15,16,17,-1,-1,-1,-1,-1,-1,-1,-1,-1,-1,-1,-1,-1,-1,-1,-1,-1,15,17,15,17,-1,-1,-1,-1,-1,-1,-1,-1,-1,-1,-1,-1,-1,-1,-1,-1,-1,-1,-1,-1,-1,-1,15,16,17,-1,-1,-1,-1,-1,-1,15,16,16,16,16,16,16,16,17,-1
16,16,16,16,16,16,16,16,17,17,-1,15,16,16,16,16,16,16,17,-1,-1,-1,-1,-1,-1,-1,-1,-1,-1,-1,-1,-1,-1,-1,-1,-1,-1,15,17,15,16,16,16,16,16,16,16,16,17,15,16,17,-1,-1,15,17,-1,-1,15,17,-1,15,17,-1,15,16,16,17,16,16,16,16,16,16,17,15,16,16,16,16,16,16,17,15,16,16,16,16,16,16,17,-1,-1,15,16,16,16,16,17,15,16,17,-1,15,16,17,-1,-1,-1,-1,-1,-1,-1,-1,-1,-1,-1,-1,-1,-1,15,16,17,15,16,17,15,16,16,16,16,16,16,16,17,15,16,17,-1,-1,-1,-1,-1,-1,-1,-1,-1,-1,-1,-1,-1,-1,-1,-1,-1,15,17,15,17,-1,-1,-1,-1,-1,-1,-1,-1,-1,-1,-1,-1,-1,-1,-1,-1,-1,-1,-1,-1,-1,-1,15,16,17,-1,-1,-1,-1,-1,-1,15,16,16,16,16,16,16,16,17,-1
16,16,16,16,16,16,16,16,17,17,-1,15,16,16,16,16,16,16,17,-1,-1,-1,-1,-1,-1,-1,-1,-1,-1,-1,-1,-1,-1,-1,-1,-1,-1,15,17,15,16,16,16,16,16,16,16,16,17,15,16,17,-1,-1,15,17,-1,-1,15,17,-1,15,17,-1,15,16,16,17,16,16,16,16,16,16,17,15,16,16,16,16,16,16,17,15,16,16,16,16,16,16,17,-1,-1,15,16,16,16,16,17,15,16,17,-1,15,16,17,-1,-1,-1,-1,-1,-1,-1,-1,-1,-1,-1,-1,-1,-1,15,16,17,15,16,17,15,16,16,16,16,16,16,16,17,15,16,17,-1,-1,-1,-1,-1,-1,-1,-1,-1,-1,-1,-1,-1,-1,-1,-1,-1,15,17,15,17,-1,-1,-1,-1,-1,-1,-1,-1,-1,-1,-1,-1,-1,-1,-1,-1,-1,-1,-1,-1,-1,-1,15,16,17,-1,-1,-1,-1,-1,-1,15,16,16,16,16,16,16,16,17,-1
16,16,16,16,16,16,16,16,17,17,-1,15,16,16,16,16,16,16,17,-1,-1,-1,-1,-1,-1,-1,-1,-1,-1,-1,-1,-1,-1,-1,-1,-1,-1,15,17,15,16,16,16,16,16,16,16,16,17,15,16,17,-1,-1,15,17,-1,-1,15,17,-1,15,17,-1,15,16,16,17,16,16,16,16,16,16,17,15,16,16,16,16,16,16,17,15,16,16,16,16,16,16,17,-1,-1,15,16,16,16,16,17,15,16,17,-1,15,16,17,-1,-1,-1,-1,-1,-1,-1,-1,-1,-1,-1,-1,-1,-1,15,16,17,15,16,17,15,16,16,16,16,16,16,16,17,15,16,17,-1,-1,-1,-1,-1,-1,-1,-1,-1,-1,-1,-1,-1,-1,-1,-1,-1,15,17,15,17,-1,-1,-1,-1,-1,-1,-1,-1,-1,-1,-1,-1,-1,-1,-1,-1,-1,-1,-1,-1,-1,-1,15,16,17,-1,-1,-1,-1,-1,-1,15,16,16,16,16,16,16,16,17,-1
21,21,21,21,21,21,21,21,22,22,-1,15,16,16,16,16,16,16,17,-1,-1,-1,-1,-1,-1,-1,-1,-1,-1,-1,-1,-1,-1,-1,-1,-1,-1,15,17,15,16,16,16,16,16,16,16,16,17,15,16,17,-1,-1,15,17,-1,-1,15,17,-1,15,17,-1,15,16,16,17,16,16,16,16,16,16,17,15,16,16,16,16,16,16,17,15,16,16,16,16,16,16,17,-1,-1,15,16,16,16,16,17,15,16,17,-1,15,16,17,-1,-1,-1,-1,-1,-1,-1,-1,-1,-1,-1,-1,-1,-1,15,16,17,15,16,17,15,16,16,16,16,16,16,16,17,15,16,17,-1,-1,-1,-1,-1,-1,-1,-1,-1,-1,-1,-1,-1,-1,-1,-1,-1,15,17,15,17,-1,-1,-1,-1,-1,-1,-1,-1,-1,-1,-1,-1,-1,-1,-1,-1,-1,-1,-1,-1,-1,-1,15,16,17,-1,-1,-1,-1,-1,-1,15,16,16,16,16,16,16,16,17,-1
